gaz50k	county	name
LO	C of Lon	City of London
AG	Angus	Angus
RD	Roch	Rochdale
BC	Brackn	Bracknell Forest
YY	Stock	Stockport
YS	Sou-on-Sea	Southend-on-Sea
RH	Rho Cyn Taf	Rhondda,Cynon,Taff
ES	E Susx	East Sussex
WH	C of Wolv	City of Wolverhampton
WF	Wal F	Waltham Forest
DE	Denb	Denbighshire
LL	Lincs	Lincolnshire
WB	W Berks	West Berkshire
KC	Ken & Ch	Royal Borough of Kensington & Chelsea
HN	Hack	Hackney
FF	Fife	Fife
TH	T Ham	Tower Hamlets
SM	Stock on T	Stockton on Tees
WE	Wakf	Wakefield
BZ	C of Bris	City of Bristol
HE	Heref	Herefordshire
WX	Wrex	Wrexham
YT	Slough	Slough
WK	Warw	Warwickshire
WG	Warr	Warrington
CW	Conwy	Conwy
HP	Hants	Hampshire
WA	Wals	Walsall
CA	Cald	Calderdale
AB	Aberd	Aberdeenshire
GY	Gwyn	Gwynedd
NE	Newp	Newport
EX	Essex	Essex
GL	C of Glas	Glasgow City
BR	Brom	Bromley
SX	S Ayr	South Ayrshire
LN	Luton	Luton
SI	Shetld	Shetland Islands
HD	Herts	Hertfordshire
KN	Know	Knowsley
WN	Wigan	Wigan
KG	King	Kingston upon Thames
NS	N Som	North Somerset
OK	Orkney	Orkney Islands
RE	Renf	Renfrewshire
IL	Isling	Islington
PY	C of Plym	City of Plymouth
HS	Houns	Hounslow
WC	Win & Maid	Windsor and Maidenhead
BN	Barnet	Barnet
TB	Torbay	Torbay
TR	Traf	Trafford
EN	Enf	Enfield
HA	Halton	Halton
NW	N upon Ty	Newcastle upon Tyne
FL	Flint	Flintshire
SD	Swin	Swindon
BE	Brig	Bridgend
WI	N Eil	Na h-Eileanan an Iar
CN	Corn	Cornwall
HG	Hargy	Haringey
SW	Sthwk	Southwark
SN	St Hel	St Helens
SZ	Sutton	Sutton
BK	C Beds	Central Bedfordshire
EY	E Yorks	East Riding of Yorkshire
WO	Worcs	Worcestershire
ER	E Renf	East Renfrewshire
BB	Black w Dar	Blackburn with Darwen
NA	N Ayr	North Ayrshire
XX	0	XXXXXXXX
WT	Wilts	Wiltshire
CY	Croy	Croydon
WJ	Wok	Wokingham
MM	Monm	Monmouthshire
ED	E Dunb	East Dunbartonshire
HL	Highld	Highland
LD	Leeds	Leeds
TU	Thurr	Thurrock
MI	Midlo	Midlothian
KH	C of K upon H	City of Kingston upon Hull
SQ	Sol	Solihull
BX	Bexley	Bexley
BH	C of Bri & Hov	City of Brighton and Hove
SC	Salf	Salford
SY	S Tyne	South Tyneside
BM	Bucks	Buckinghamshire
DL	Darl	Darlington
GH	Ghead	Gateshead
HF	Ham & Ful	Hammersmith &Fulham
NT	Notts	Nottinghamshire
SE	Sefton	Sefton
NP	Nth Pt Talb	Neath Port Talbot
NH	Newham	Newham
WM	C of West	City of Westminster
NI	N Lincs	North Lincolnshire
BT	Brent	Brent
LB	Lam	Lambeth
DN	Devon	Devon
DT	Dorset	Dorset
SJ	C of Stoke	City of Stoke-on-Trent
ST	Somer	Somerset
DU	Durham	Durham
RG	Read	Reading
SV	Sund	Sunderland
KL	Kirk	Kirklees
HR	Harrow	Harrow
SS	Swan	Swansea
NC	NE Lincs	North East Lincolnshire
IM	I of M	Isle of Man
BF	Beds	Bedford
CH	Ches E	Cheshire East
PW	Powys	Powys
LA	Lancs	Lancashire
CU	Cumbr	Cumbria
EA	E Ayr	East Ayrshire
DR	Donc	Doncaster
HV	Hav	Havering
AR	Arg & Bt	Argyll and Bute
LT	Leic	Leicestershire
SH	Shrops	Shropshire
TS	Tames	Tameside
SP	Sheff	Sheffield
BL	Barns	Barnsley
CE	Cered	Ceredigion
HT	Hartpl	Hartlepool
ME	Medway	Medway
RL	Rut	Rutland
NL	N Lanak	North Lanarkshire
SR	Stir	Stirling
BP	Blackp	Blackpool
NN	Northnts	Northamptonshire
CD	Card	Cardiff
BU	Bourne	Bournemouth
KT	Kent	Kent
AN	C of Aber	Aberdeen City
VG	V of Glam	The Vale of Glamorgan
NY	N Yks	North Yorkshire
BS	Bath & NE Somer	Bath and North East Somerset
BI	Birm	Birmingham
NG	C of Nott	City of Nottingham
NK	Norf	Norfolk
DD	C of Dun	Dundee City
GW	Gren	Greenwich
WS	W Susx	West Sussex
SG	S Glos	South Gloucestershire
GR	Glos	Gloucestershire
MO	Moray	Moray
TF	Torf	Torfaen
SU	Surrey	Surrey
CV	Cov	Coventry
BY	Bury	Bury
WR	Wirral	Wirral
HI	Hill	Hillingdon
MK	Mil Key	Milton Keynes
BD	Bark & Dag	Barking & Dagenham
MT	Merth Tyd	Merthyr Tydfil
RT	Rich	Richmond upon Thames
SF	Staffs	Staffordshire
WP	Wrekin	Telford and Wrekin
DB	C of Derb	City of Derby
OH	Oldham	Oldham
DZ	Dudley	Dudley
RO	Roth	Rotherham
CM	Camden	Camden
PB	Pemb	Pembrokeshire
IW	I of W	Isle of Wight
DG	D & G	Dumfries and Galloway
MR	Merton	Merton
EB	C of Edin	City of Edinburgh
RC	Red & Cl	Redcar & Cleveland
BG	Blae Gw	Blaenau Gwent
WD	W Dunb	West Dunbartonshire
NR	N Tyne	North Tyneside
PO	C of Port	City of Portsmouth
EG	Ealing	Ealing
LC	C of Leic	City of Leicester
PL	Poole	Poole
ND	Northum	Northumberland
CF	Caer	Caerphilly
CT	Carm	Carmarthenshire
BA	Brad	Bradford
SA	Sand	Sandwell
WW	Wan	Wandsworth
MB	Midd	Middlesbrough
WL	W Loth	West Lothian
MA	Man	Manchester
EL	E Loth	East Lothian
ON	Oxon	Oxfordshire
BO	Bolton	Bolton
IN	Inverc	Inverclyde
SO	C of Soton	City of Southampton
IS	I Scilly	Isles of Scilly
SB	Scot Bord	Scottish Borders
LP	Liv	Liverpool
LS	Lew	Lewisham
YK	York	York
FA	Falk	Falkirk
RB	Redbr	Redbridge
CB	Cambs	Cambridgeshire
IA	I of Angl	Isle of Anglesey
PK	Pth & Kin	Perth and Kinross
CC	Ches W	Cheshire West and Chester
SL	S Lanak	South Lanarkshire
SK	Suff	Suffolk
PE	C of Peterb	City of Peterborough
DY	Derby	Derbyshire
CL	Clackm	Clackmannanshire
